##########
#35  9   #
# _2 3 47#
#  ~~ 19~#
##########
