######################
# _                  # 
#~~~~~~~~~~~~~~~~~~~ # 
#                    # 
# ~~~~~~~~~~~~~~~~~~~# 
#                    # 
#~~~~~~~~~~~~~~~~~~~ # 
#                    # 
# ~~~~~~~~~~~~~~~~~~~# 
#                    # 
#                   9# 
######################
