####################
#            #     #
# _       #  ##    #
#  ~~   ~ #        #
####################
